Арахнофобия
Анатидаефобия - боязнь что где-то есть утка, которая следит за вами
Аквафобия - боязнь воды
Агорафобия - боязнь открытых пространств
Агрофобия - боязнь секса
Акрофобия - боязнь высоты
Ахлуофобия - боязнь темноты
Аутофобия - боязнь одинечства
Нет фобий
Атихифобия - боязнь совершить ошибку
Апопатофобия - боязнь заходидить в туалеты
Апейрофобия - боязнь бесконечности
Алгофобия - боязнь боли
Балистофобия - боязнь получить пулевое ранение
Блаптофобия - Боязнь нанести кому-нибудь повреждение
Венерофобия - боязнь подхватить ЗППП
Вербофобия - страх отдельных слов
Галитофобия - боязнь вони изо рта
Гидрозофобия - боязнь вспотеть
Гаптофобия - боязнь прикосновений
Гиерофобия - боязнь религиозных предметов
Гимнофобия - боязнь наготы
Гелиофобия - боязнь солнечного света
Гелотофобия - страх оказаться обьектом насмешек
Гоплофобия - боязнь оружия
Геронтофобия - страх общения с пожилыми людьми и постареть
Гравидофобия - боязнь беременности
Герпетофобия - боязнь рептилий
Декстрофобия - боязнь вещей расположенных справа
Демонофобия - боязнь дьявола
Дисморфофобия - боязнь собственной внешности
Зоофобия - боязнь животных
Инсектофобия - боязнь насекомых
Калифобия - боязнь красоты
Климакофобия - боязнь лестниц
Компьютерофобия - боязнь компов
Кенофобия - боязнь больших незаполненных пространств
Копрофобия - боязнь фекалий
Коулрофобия - боязнь клоунов
Клаустрофобия
Канинофобия - боязнь собак
Кремнофобия - боязнь смотреть в пропасть
Кумпунофобия - боязнь пуговиц
Лалофобия - боязнь говорить из-за возможного заикания
Мегалофобия - боязнь больших предметов
Мирмекофобия - боязнь муравьев
Мусофобия - боязнь мышей и крыс
Некрофобия - боязнь трупов
Неофобия - боязнь всего нового
Дентофобия - боязнь стоматологов
Номофобия - боязнь остаться без мобильного телефона
Нозофобия - боязнь заболеть
Олькофобия - боязнь возвращения домой
Омброфобия - боязнь попасть под дождь
Онанофобия - боязнь вредных последствий онанизма
Орнитофобия - боязнь птиц
Офидиофобия - боязнь змей
Охлофобия - боязнь толпы
Панофобия - постоянный страх по неизвестной причине
Парурез - боязнь мочеиспускания на людях
Педиофобия - боязнь предметов иметирующих человека
Педофобия - навязчивый страх детей
Пейрафобия - боязнь публичного выступления
Петтофобия - боязнь неударжания газов при посторонних
Пирофобия - боязнь огня
Психрофобия - боязнь холода
Рипофобия - боязнь грязи
Робофобия - страх по отношению к робототехнике
Скопофобия - боязнь пристального разглядывания другими
Спектрофобия - боязнь призраков
Топофобия - боязнь остаться одному
Танатофобия - боязнь смерти
Тафофобия - боязнь быть погребенным заживо
Терророфобия - боязнь терроризма
Теофобия - боязнь Бога
Термофобия - боязнь жары
Фагофобия - боязнь глотания
Фармакофобия - боязнь принимать лекарства
Филофобия - боязнь влюбиться
Фобофобия - боязнь фобий
Хемафобия - боязнь химии